Y,Y,O,O,R,R,-,-,-,-,-,-,B
Y,O,O,R,R,-,-,-,-,-,-,B,B
O,O,R,R,-,-,-,-,-,-,B,B,P
O,R,R,-,-,-,-,-,-,B,B,P,P
R,R,-,-,-,-,-,-,B,B,P,P,M
R,-,-,-,-,-,-,B,B,P,P,M,M
-,-,-,-,-,-,B,B,P,P,M,M,-
-,-,-,-,-,B,B,P,P,M,M,-,-
-,-,-,-,B,B,P,P,M,M,-,-,-
-,-,-,B,B,P,P,M,M,-,-,-,-
-,-,B,B,P,P,M,M,-,-,-,-,-
-,B,B,P,P,M,M,-,-,-,-,-,-
B,B,P,P,M,M,-,-,-,-,-,-,R
B,P,P,M,M,-,-,-,-,-,-,R,R
P,P,M,M,-,-,-,-,-,-,R,R,O
P,M,M,-,-,-,-,-,-,R,R,O,O
M,M,-,-,-,-,-,-,R,R,O,O,Y
M,-,-,-,-,-,-,R,R,O,O,Y,Y