-,-,-,-,-,-,-,-,-,-,-,-,-
-,-,-,-,-,-,-,-,-,-,-,-,-
-,-,-,-,-,-,-,-,-,-,-,-,-
-,-,-,-,-,-,-,-,-,-,-,-,-
Y,Y,Y,Y,Y,Y,Y,Y,Y,Y,Y,Y,Y
Y,Y,Y,Y,Y,Y,Y,Y,Y,Y,Y,Y,Y
-,-,-,-,-,-,-,-,-,-,-,-,-
R,R,G,-,G,R,R,R,G,-,G,R,R
R,R,G,-,G,R,R,R,G,-,G,R,R
R,R,G,-,G,R,R,R,G,-,G,R,R
R,R,G,-,G,R,R,R,G,-,G,R,R
-,-,-,-,-,-,-,-,-,-,-,-,-
W,W,W,W,W,W,W,W,W,W,W,W,W
W,W,W,W,W,W,W,W,W,W,W,W,W
-,-,-,-,-,-,-,-,-,-,-,-,-
-,-,-,-,-,-,-,-,-,-,-,-,-
-,-,-,-,-,-,-,-,-,-,-,-,-
-,-,-,-,-,-,-,-,-,-,-,-,-