-,-,-,-,-,-,-,-,-,-,-,-,-
-,-,-,-,-,-,-,-,-,-,-,-,-
A,A,A,A,A,-,-,-,-,-,-,-,-
A,B,B,B,A,-,-,-,-,-,-,-,-
A,B,-,B,A,-,-,-,-,-,-,-,-
A,B,B,B,A,-,-,-,-,-,-,-,-
A,A,A,A,A,-,-,-,-,-,-,-,-
-,-,-,-,-,-,-,A,A,A,A,A,-
-,-,-,-,-,-,-,A,L,L,L,A,-
-,-,-,-,-,-,-,A,L,-,L,A,-
-,-,-,-,-,-,-,A,L,L,L,A,-
-,-,-,-,-,-,-,A,A,A,A,A,-
-,-,-,-,-,-,-,-,-,-,-,-,-
-,-,A,A,A,A,A,-,-,-,-,-,-
-,-,A,R,R,R,A,-,-,-,-,-,-
-,-,A,R,-,R,A,-,-,-,-,-,-
-,-,A,R,R,R,A,-,-,-,-,-,-
-,-,A,A,A,A,A,-,-,-,-,-,-