S,S,S,S,S,P,-,-,P,O,O,O,O
-,-,S,-,-,P,-,-,P,O,-,-,-
-,-,S,-,-,P,P,P,P,O,O,O,O
-,-,S,-,-,P,-,-,P,O,-,-,-
-,-,S,-,-,P,-,-,P,O,O,O,O
-,-,-,-,-,-,-,-,-,-,-,-,-
-,-,-,-,-,-,-,-,-,-,-,-,-
W,W,W,W,R,-,-,-,R,D,D,D,-
W,-,-,-,R,R,-,-,R,D,-,-,D
W,W,W,W,R,-,R,-,R,D,-,-,D
W,-,-,-,R,-,-,R,R,D,-,-,D
W,W,W,W,R,-,-,-,R,D,D,D,-
-,-,-,-,-,-,-,-,-,-,-,-,-
A,A,A,A,A,A,A,A,A,A,A,A,A
A,A,A,A,A,A,A,A,A,A,A,A,A
A,A,A,A,A,A,A,A,A,A,A,A,A
A,A,A,A,A,A,A,A,A,A,A,A,A
A,A,A,A,A,A,A,A,A,A,A,A,A