Y,Y,Y,-,-,-,-,-,-,-,-,-,-
-,Y,Y,Y,-,-,-,-,-,-,-,-,-
-,-,-,Y,Y,Y,-,-,-,-,-,-,M
Y,-,-,-,-,-,-,-,-,-,-,M,M
Y,Y,-,-,-,-,-,-,-,-,-,M,M
Y,Y,Y,-,-,-,-,-,-,-,M,M,M
-,-,Y,Y,-,-,-,-,-,M,M,M,-
S,-,-,-,-,-,-,-,-,M,M,-,-
S,-,-,-,-,-,-,-,M,M,-,-,-
S,S,-,-,-,-,-,-,M,-,-,-,-
-,S,S,-,-,-,-,-,-,-,-,-,-
-,-,S,S,-,-,-,-,-,-,-,-,-
-,-,-,S,-,-,-,-,-,S,-,-,-
-,-,-,-,-,M,M,-,-,S,S,-,-
-,-,-,-,M,M,-,-,-,-,S,S,S
-,-,M,M,M,-,-,-,-,-,-,S,S
-,M,M,M,-,-,-,-,-,-,-,S,S
M,M,M,-,-,-,-,-,-,-,-,-,S