-,-,-,-,-,-,-,-,-,-,-,-,-
-,-,-,-,-,-,-,-,-,-,-,-,-
-,-,-,-,-,-,W,-,-,-,-,-,-
-,-,-,-,-,-,W,-,-,-,-,-,-
-,-,-,-,-,-,W,-,-,-,-,-,-
-,-,-,-,-,-,W,-,-,-,-,-,-
-,-,-,-,-,-,W,-,-,-,-,-,-
-,-,-,-,-,-,W,-,-,-,-,-,-
-,-,-,-,-,R,R,R,-,-,-,-,-
-,-,-,-,-,B,B,B,-,-,-,-,-
-,-,-,W,-,B,D,B,-,W,-,-,-
-,-,-,W,-,B,D,B,-,W,-,-,-
R,-,-,W,W,W,D,W,W,W,-,-,R
R,-,A,A,A,A,A,A,A,A,A,-,R
R,D,D,-,-,W,A,W,-,-,D,D,R
W,W,-,-,-,W,W,W,-,-,-,W,W
R,-,-,-,-,-,-,-,-,-,-,-,R
R,-,-,-,-,-,-,-,-,-,-,-,R
