-,-,-,-,-,-,-,-,-,-,-,-,-
-,-,-,-,-,-,-,-,-,-,-,-,-
-,-,-,-,-,-,-,-,-,-,-,-,-
-,-,-,-,-,-,-,-,-,-,-,-,-
-,Y,Y,Y,-,W,W,W,-,Y,Y,Y,-
-,M,M,M,-,O,O,O,-,M,M,M,-
-,B,B,B,-,S,S,S,-,B,B,B,-
-,R,R,R,-,L,L,L,-,R,R,R,-
-,L,L,L,-,R,R,R,-,L,L,L,-
-,S,S,S,-,B,B,B,-,S,S,S,-
-,O,O,O,-,M,M,M,-,O,O,O,-
-,W,W,W,-,Y,Y,Y,-,W,W,W,-
-,-,-,-,-,-,-,-,-,-,-,-,-
-,-,-,-,-,-,-,-,-,-,-,-,-
-,-,-,-,-,-,-,-,-,-,-,-,-
-,-,-,-,-,-,-,-,-,-,-,-,-
-,-,-,-,-,-,-,-,-,-,-,-,-
-,-,-,-,-,-,-,-,-,-,-,-,-