-,-,-,-,-,-,-,-,-,-,-,-,-
-,-,-,-,-,-,-,-,-,-,-,-,-
-,G,-,G,-,-,-,-,-,G,-,G,-
-,G,L,G,-,-,-,-,-,G,L,G,-
-,G,S,G,-,-,-,-,-,G,S,G,-
-,G,G,G,-,-,-,-,-,G,G,G,-
-,-,-,-,-,-,-,-,-,-,-,-,-
-,-,-,-,M,W,W,W,Y,-,-,-,-
-,-,-,-,M,O,O,O,Y,-,-,-,-
-,-,-,-,M,S,S,S,Y,-,-,-,-
-,-,-,-,M,L,L,L,Y,-,-,-,-
-,-,-,-,M,R,R,R,Y,-,-,-,-
-,-,-,-,M,B,B,B,Y,-,-,-,-
-,-,-,-,-,-,-,-,-,-,-,-,-
-,-,-,-,-,-,-,-,-,-,-,-,-
-,-,-,-,-,-,-,-,-,-,-,-,-
-,-,-,-,-,-,-,-,-,-,-,-,-
-,-,-,-,-,-,-,-,-,-,-,-,-