W,W,W,W,W,W,W,W,W,W,W,W,W
A,A,A,A,A,A,A,A,A,A,A,A,A
-,-,-,-,-,-,-,-,-,-,-,-,-
-,-,-,-,-,-,-,-,-,-,-,-,-
-,-,-,-,-,-,-,-,-,-,-,-,-
-,-,-,-,-,-,-,-,-,-,-,-,-
-,-,-,-,S,S,S,S,S,-,-,-,-
-,-,-,S,-,-,-,-,-,S,-,-,-
-,-,S,-,A,A,A,A,-,-,S,-,-
-,S,-,A,-,R,-,-,A,-,-,S,-
O,-,A,-,L,-,L,-,-,A,-,-,S
-,O,-,A,-,R,-,-,A,-,-,O,-
-,-,O,-,A,A,A,A,-,-,O,-,-
-,-,-,O,-,-,-,-,-,O,-,-,-
-,-,-,-,O,O,O,O,O,-,-,-,-
-,-,-,-,-,-,-,-,-,-,-,-,-
-,-,-,-,-,-,-,-,-,-,-,-,-
-,-,-,-,-,-,-,-,-,-,-,-,-