W,W,S,S,B,B,A,L,L,D,D,Y,Y
W,S,S,B,B,A,A,A,L,L,D,D,Y
W,S,B,B,A,A,-,A,A,L,L,D,Y
S,S,B,A,A,-,-,-,A,A,L,D,D
S,B,B,A,-,-,-,-,-,A,L,L,D
B,B,A,A,-,-,-,-,-,A,A,L,L
B,A,A,-,-,-,-,-,-,-,A,A,L
B,A,-,-,-,-,G,-,-,-,-,A,L
A,A,-,-,-,G,G,G,-,-,-,A,A
A,A,-,-,-,G,G,G,-,-,-,A,A
L,A,-,-,-,-,G,-,-,-,-,A,B
L,A,A,-,-,-,-,-,-,-,A,A,B
L,L,A,A,-,-,-,-,-,A,A,B,B
D,L,L,A,-,-,-,-,-,A,B,B,S
D,D,L,A,A,-,-,-,A,A,B,S,S
Y,D,L,L,A,A,-,A,A,B,B,S,W
Y,D,D,L,L,A,A,A,B,B,S,S,W
Y,Y,D,D,L,L,A,B,B,S,S,W,W