-,-,-,-,-,-,-,-,-,-,-,-,-
-,-,-,-,-,-,-,-,-,-,-,-,-
-,-,-,-,-,-,-,-,-,-,-,-,-
-,-,-,-,-,-,-,-,-,-,-,-,-
A,A,A,A,A,A,A,A,A,A,A,A,A
R,R,R,R,R,R,R,R,R,R,R,R,R
Y,Y,Y,Y,Y,Y,Y,Y,Y,Y,Y,Y,Y
B,B,B,B,B,B,B,B,B,B,B,B,B
M,M,M,M,M,M,M,M,M,M,M,M,M
L,L,L,L,L,L,L,L,L,L,L,L,L
-,-,-,-,-,-,-,-,-,-,-,-,-
-,-,-,-,-,-,-,-,-,-,-,-,-
-,-,-,-,-,-,-,-,-,-,-,-,-
-,-,-,-,-,-,-,-,-,-,-,-,-
-,-,-,-,-,-,-,-,-,-,-,-,-
-,-,-,-,-,-,-,-,-,-,-,-,-
-,-,-,-,-,-,-,-,-,-,-,-,-
-,-,-,-,-,-,-,-,-,-,-,-,-